***********
**o********
**    x* **
** ***** **
** * *   **
** * *** **
**x  *   **
**** * * **
**     * **
********x**
***********