***********
**o********
**     * **
** ***** **
** * *   **
** * *** **
**   *   **
**** * * **
**     * **
********x**
***********